┌────────┐
│        │
│        │
│        │
│        │
└────────┘
